0 ,0 ,0 ,0 ,0 ,0 ,0 ,2 ,0 ,0 ,0 ,0 ,0 ,0 ,0 ,0 ,0
0 ,1 ,0 ,0 ,0 ,0 ,0 ,2 ,0 ,0 ,0 ,0 ,0 ,0 ,0 ,0 ,0
0 ,0 ,0 ,0 ,0 ,0 ,0 ,2 ,0 ,0 ,0 ,4 ,5 ,5 ,6 ,0 ,0
0 ,0 ,0 ,0 ,0 ,0 ,0 ,2 ,0 ,0 ,0 ,8 ,9 ,9 ,10,0 ,0
0 ,0 ,0 ,0 ,0 ,0 ,0 ,2 ,0 ,0 ,0 ,8 ,9 ,9 ,10,0 ,0
0 ,0 ,0 ,0 ,0 ,0 ,0 ,2 ,0 ,0 ,0 ,8 ,9 ,9 ,10,0 ,0
0 ,0 ,0 ,0 ,0 ,0 ,0 ,2 ,0 ,0 ,0 ,12,13,13,14,0 ,0
0 ,0 ,0 ,0 ,0 ,0 ,0 ,3 ,0 ,0 ,0 ,0 ,0 ,0 ,0 ,0 ,0
0 ,0 ,0 ,0 ,0 ,0 ,0 ,2 ,0 ,0 ,0 ,0 ,0 ,0 ,0 ,0 ,0
0 ,0 ,0 ,0 ,0 ,0 ,0 ,2 ,0 ,0 ,0 ,0 ,0 ,0 ,0 ,0 ,0
0 ,0 ,4 ,5 ,6 ,0 ,0 ,2 ,0 ,0 ,0 ,0 ,0 ,0 ,0 ,0 ,0
0 ,0 ,8 ,9 ,10,0 ,0 ,2 ,0 ,0 ,0 ,0 ,0 ,0 ,0 ,0 ,0
0 ,0 ,12,13,14,0 ,0 ,2 ,0 ,0 ,0 ,0 ,0 ,0 ,0 ,0 ,0
0 ,0 ,0 ,0 ,0 ,0 ,0 ,2 ,0 ,0 ,0 ,0 ,0 ,0 ,0 ,0 ,0
